11111111111111111111111111111111
16666666666666111111111111111111
51111111511111013101111151111111
51111115551111000001111555111111
51113111511131111111311151113111
51115511511551111111551151155111
51115155555151111111515555515111
51115155555151115111515555515111
51115113431151155511511343115111
51111500000511115111150000051111
51111155555155115115515555511111
51111111111151555551511111111111
51111111111151555551511111111111
51111111111151555551511111111111
51111111111151134311511111111111
51111131111115000005111111311111
50000000511111555551111150000000
51111111511111111111111151111111
51111111511111111111111151111111
51111111511111111111111151111111
51111111511111113111211151111111
00000000000000000000000000000000
