11111111111111111111111111111111
11111111111111111111311111114111
00000011111111111110000500000000
11110001111111111100011511111111
11111000111111111000111511111111
11111100011111130001111511111111
31411100001111100001111511113111
00050000000111000005000000000000
11151111000050000115111111111111
11151111111151111115111111111111
11151111111151111115111111111111
11153411111151111115111113111111
50000511111151111100005000111111
51111511111151111111115111111111
51111511111111111111115111111111
51111511111111111111115111111111
51111511111131111114115111111111
51111500000000500000000000005000
51111111111111511111111111115111
51111111111111511111111111115111
51111111111111511121111111115111
00000000000000000000000000000000
