wwwwwwwwwwwww
w....w....g.w
w...www.....w
w.e..www....w
w..wwwwwww..w
w......w....w
w....w...e..w
w@...w+...e.w
wwwwwwwwwwwww
