wwwwwwwwwwwww
w.e.gw....e.w
w..www......w
w..........ew
w.......wwwww
w.......w+..w
w...w...w...w
w@..w.......w
wwwwwwwwwwwww
