wwwwwwwwwwwww
w..........gw
w....w......w
w.w.w..e....w
w+w.........w
wwe..e..e...w
w..w..w.w.w.w
w...@.......w
wwwwwwwwwwwww
