wwwwwwwwwwwww
w..e.ww....@w
w....w......w
w.w.....wwwww
w+w........ew
w.w..wwwwwwww
w.......w...w
w...ew....wgw
wwwwwwwwwwwww
