wwwwwwwwwwwww
w@.......w..w
w..w........w
w...w...w.+ww
www.we..wwwww
w.......w.g.w
w.e.........w
w.....e.....w
wwwwwwwwwwwww