 ######
#.$@  #
###   #
#.##  #
# #   ##
#$ X$  #
#   .  #
########
