######
#.  .#
#    #
#$  $#
#@   #
######
