  #####
###   #
#.@$  #
### $.#
#.##$ #
# # . ##
#$ X$$.#
#   .  #
########
