########
#      #
# .XX$@#
#      #
#####  #
   ####
