####
#  ####
# . . #
# $$X@#
##    #
 ######
