#####
#@  ##
#.$X #
#  # #
#    #
######
